ϩⲁⲅⲓⲟⲥ	Greek
ϩⲁⲗⲁⲥⲥⲁ	Greek
ϩⲉⲑⲛⲓⲕⲟⲥ	Greek
ϩⲉⲣⲙⲏⲥ	Greek
ϩⲓⲉⲣⲉⲩⲥ	Greek
ϩⲓⲉⲣⲟⲩⲥⲁⲗⲏⲙ	Hebrew
ϩⲟⲙⲟⲗⲟⲅⲉⲓ	Greek
ϩⲟⲥⲟⲛ	Greek
ϩⲟⲧⲁⲛ	Greek
ϩⲩⲡⲟⲧⲁⲅⲏ	Greek
ϩⲩⲡⲟⲧⲁⲥⲥⲉ	Greek
ⲁⲅⲁⲑⲟⲛ	Greek
ⲁⲅⲁⲑⲟⲥ	Greek
ⲁⲅⲅⲉⲗⲟⲥ	Greek
ⲁⲅⲅⲏⲛ	Greek
ⲁⲅⲅⲓⲟⲛ	Greek
ⲁⲓⲥⲑⲁⲛⲉ	Greek
ⲁⲓⲱⲛ	Greek
ⲁⲗⲉⲝⲁⲛⲇⲣⲟⲥ	Greek
ⲁⲗⲗⲁ	Greek
ⲁⲛⲁⲅⲕⲏ	Greek
ⲁⲛⲟⲙⲓⲁ	Greek
ⲁⲡⲁ	Hebrew
ⲁⲡⲟⲥⲧⲟⲗⲟⲥ	Greek
ⲁⲡⲟⲫⲁⲥⲓⲥ	Greek
ⲁⲣⲁ	Greek
ⲁⲣⲭⲏⲗⲏⲥⲧⲏⲥ	Greek
ⲁⲥⲕⲏⲥⲓⲥ	Greek
ⲁⲩⲝⲁⲛⲉ	Greek
ⲁⲫⲑⲟⲛⲓⲁ	Greek
ⲃⲁⲣⲟⲥ	Greek
ⲃⲁⲥⲕⲁⲛⲟⲥ	Greek
ⲃⲁⲩⲕⲁⲗⲓⲟⲛ	Greek
ⲃⲟⲏⲑⲓⲁ	Greek
ⲃⲟⲏⲑⲟⲥ	Greek
ⲅⲁⲣ	Greek
ⲅⲣⲁⲫⲏ	Greek
ⲇⲉ	Greek
ⲇⲓⲁⲃⲟⲗⲟⲥ	Greek
ⲇⲓⲁⲕⲟⲛⲓⲁ	Greek
ⲇⲓⲕⲁⲓⲟⲛ	Greek
ⲇⲓⲕⲁⲓⲟⲥ	Greek
ⲉⲓⲙⲏⲧⲓ	Greek
ⲉⲓⲧⲉ	Greek
ⲉⲗⲁⲭⲓⲥⲧⲟⲛ	Greek
ⲉⲛⲧⲟⲗⲏ	Greek
ⲉⲝⲁⲡⲁⲧⲁ	Greek
ⲉⲡⲉⲓⲇⲏ	Greek
ⲉⲡⲓⲥⲧⲏⲙⲏ	Greek
ⲉⲡⲓⲥⲧⲟⲗⲏ	Greek
ⲉⲥⲑⲁⲛⲉ	Greek
ⲉⲩϩⲁ	Hebrew
ⲉⲫⲣⲉⲙ	Hebrew
ⲏ	Greek
ⲑⲉⲟⲇⲟⲣⲟⲥ	Greek
ⲑⲗⲓⲯⲓⲥ	Greek
ⲓⲏⲥⲟⲩⲥ	Hebrew
ⲓⲥⲣⲁⲏⲗ	Hebrew
ⲕⲁⲣⲡⲟⲥ	Greek
ⲕⲁⲧⲁ	Greek
ⲕⲁⲧⲁⲫⲣⲟⲛⲉⲓ	Greek
ⲕⲟⲓⲛⲱⲛⲟⲥ	Greek
ⲕⲟⲗⲗⲏⲅⲓⲟⲛ	Latin
ⲕⲟⲙⲉⲥ	Latin
ⲕⲟⲥⲙⲟⲥ	Greek
ⲕⲱⲗⲩⲉ	Greek
ⲗⲁⲟⲥ	Greek
ⲗⲏⲥⲧⲏⲥ	Greek
ⲗⲓⲧⲟⲩⲣⲅⲓⲁ	Greek
ⲗⲩⲡⲉⲓ	Greek
ⲗⲩⲡⲏ	Greek
ⲗⲩⲥⲧⲏⲥ	Greek
ⲙⲁⲑⲏⲧⲏⲥ	Greek
ⲙⲁⲕⲁⲣⲓⲁ	Greek
ⲙⲁⲕⲁⲣⲓⲟⲥ	Greek
ⲙⲁⲗⲓⲥⲧⲁ	Greek
ⲙⲉⲗⲉⲧⲁ	Greek
ⲙⲉⲛ	Greek
ⲙⲉⲥⲟⲩⲁⲫⲓ	Greek
ⲙⲉⲧⲁⲛⲟⲉⲓ	Greek
ⲙⲉⲧⲁⲛⲟⲓ	Greek
ⲙⲏⲡⲟⲧⲉ	Greek
ⲙⲛⲧϩⲁⲡⲗⲟⲩⲥ	Greek
ⲙⲛⲧⲁⲅⲁⲑⲟⲥ	Greek
ⲙⲛⲧⲣⲉϥϩⲉⲧⲃⲯⲩⲭⲏ	Greek
ⲙⲛⲧⲧⲉⲗⲓⲟⲥ	Greek
ⲙⲟⲛⲁⲭⲟⲥ	Greek
ⲙⲟⲛⲟⲛ	Greek
ⲙⲩⲥⲧⲏⲣⲓⲟⲛ	Greek
ⲛ̅ⲧⲟⲗⲏ	Greek
ⲛⲩⲕⲧⲉⲣⲓⲥ	Greek
ⲟⲓⲕⲟⲩⲙⲉⲛⲏ	Greek
ⲟⲣⲅⲏ	Greek
ⲟⲩⲇⲉ	Greek
ⲟⲩⲕ	Greek
ⲟⲩⲛ	Greek
ⲟⲩⲧⲉ	Greek
ⲡⲁⲑⲟⲥ	Greek
ⲡⲁⲗⲓⲛ	Greek
ⲡⲁⲛⲟⲩⲣⲅⲓⲁ	Greek
ⲡⲁⲣⲁⲃⲁ	Greek
ⲡⲁⲣⲁⲇⲉⲓⲥⲟⲥ	Greek
ⲡⲁⲣⲑⲉⲛⲟⲥ	Greek
ⲡⲁⲣⲣⲏⲥⲓⲁ	Greek
ⲡⲏⲅⲏ	Greek
ⲡⲓⲗⲁⲧⲟⲥ	Latin
ⲡⲓⲥⲧⲉⲩⲉ	Greek
ⲡⲓⲥⲧⲟⲥ	Greek
ⲡⲗⲏⲅⲏ	Greek
ⲡⲗⲏⲛ	Greek
ⲡⲛⲉⲩⲙⲁ	Greek
ⲡⲟⲗⲓⲥ	Greek
ⲡⲟⲛⲏⲣⲓⲁ	Greek
ⲡⲟⲛⲏⲣⲟⲛ	Greek
ⲡⲟⲛⲏⲣⲟⲥ	Greek
ⲡⲣⲟⲫⲏⲧⲏⲥ	Greek
ⲣⲭⲣⲉⲓⲁ	Greek
ⲥⲁⲣⲕⲓⲕⲟⲛ	Greek
ⲥⲁⲣⲝ	Greek
ⲥⲁⲧⲁⲛⲁⲥ	Hebrew
ⲥⲕⲁⲛⲇⲁⲗⲟⲛ	Greek
ⲥⲕⲉⲡⲁⲥⲧⲏⲥ	Greek
ⲥⲟⲫⲟⲥ	Greek
ⲥⲧⲉⲣⲉⲱⲙⲁ	Greek
ⲥⲩⲛⲁⲅⲱⲅⲏ	Greek
ⲥⲭⲏⲙⲁ	Greek
ⲥⲱⲙⲁ	Greek
ⲧⲉⲗⲱⲛⲏⲥ	Greek
ⲧⲉⲭⲛⲉ	Greek
ⲧⲓⲙⲱⲣⲓⲁ	Greek
ⲧⲟⲧⲉ	Greek
ⲫⲑⲟⲛⲉⲓ	Greek
ⲫⲟⲣⲉⲓ	Greek
ⲭⲁⲣⲧⲏⲥ	Greek
ⲭⲣⲓⲁ	Greek
ⲭⲣⲓⲥⲧⲟⲥ	Greek
ⲭⲱⲣⲓⲥ	Greek
ⲯⲩⲭⲏ	Greek
ⲱ	Greek
ⲱⲭⲗⲉⲓ	Greek
ⲭⲣⲉⲓⲁ	Greek
ⲉⲩⲁⲅⲅⲉⲗⲓⲟⲛ	Greek
ⲏⲥⲁⲓⲁⲥ	Hebrew
ⲉⲣⲏⲙⲟⲥ	Greek
ⲓⲱϩⲁⲛⲛⲏⲥ	Hebrew
ⲃⲁⲡⲧⲓⲥⲙⲁ	Greek
ⲕⲏⲣⲩⲥⲥⲉ	Greek
ⲙⲉⲧⲁⲛⲟⲓⲁ	Greek
ⲭⲱⲣⲁ	Greek
ⲓⲟⲩⲇⲁⲓⲁ	Hebrew
ϩⲓⲉⲣⲟⲥⲟⲗⲩⲙⲁ	Hebrew
ⲓⲟⲣⲇⲁⲛⲏⲥ	Hebrew
ⲉⲝⲟⲙⲟⲗⲟⲅⲓ	Greek
ϩⲓⲕⲁⲛⲟⲥ	Greek
ⲃⲁⲡⲧⲓⲍⲉ	Greek
ⲛⲁⲍⲁⲣⲉⲑ	Hebrew
ⲡⲉⲓⲣⲁⲍⲉ	Greek
ⲑⲏⲣⲓⲟⲛ	Greek
ⲡⲁⲣⲁⲇⲓⲇⲟⲩ	Greek
*ⲓⲍⲉ	Greek
*ⲓⲍⲉⲓ	Greek
*ⲓⲍⲓ	Greek
ⲥⲁⲃⲃⲁⲧⲟⲛ	Hebrew
ⲉⲝ*	Greek
ⲅⲣⲁⲙⲙⲁⲧⲉⲩⲥ	Greek
ⲇⲁⲩⲉⲓⲇ	Hebrew
ⲁⲣⲭⲓ*	Greek
*ⲥⲓⲥ	Greek
ⲁⲡⲟ*	Greek
ϩⲁⲙⲏⲛ	Hebrew
ⲁⲣⲭⲱⲛ	Greek
ⲇⲁⲓⲙⲱⲛⲓⲟⲛ	Greek
ⲡⲁⲣⲁ*	Greek
*ⲥⲑⲁⲓ	Greek
ⲑⲁⲗⲁⲥⲥⲁ	Greek
ϩⲱⲥⲧⲉ	Greek
ⲡⲁⲣⲁⲃⲟⲗⲏ	Greek
*ⲝ	Greek
ⲉⲧⲓ	Greek
